zanzibaris - занзибарцы
withdrawn - отозван
whacked - ударил
weaning - отлучение от груди
wealth - богатство
wanton - распутный
ward - сторожить
waggled - вилял
vitality - жизненная сила
virtue - достоинство
vigilantly - бдительно
vermouths - вермуты
verandah - веранда
ventured - рискнул
venetian - венецианский
veiled - завуалированный
vague - нечеткий
utter - полный
utterance - высказывание
uproar - шум
unshaven - небритый
unfold - разворачиваться
uncouth - неотесанный
uncanny - сверхъестественный
unbuttoned - расстегнутый
tumbled - упал
tumult - суматоха
trustworthiness - надежность
trireme - трирема
trenchant - резкий
transgression - проступок
tanned - загорелый
swung - качался
sails - паруса
wore - носил
tidal - приливный
tide - прилив
tanned - загорелый
barges - баржи
drifting up - дрейфующий вверх
canvas - холст
gleams - блестит
stretched - растянутый
interminable - бесконечный
waterway - водный путь
offing - скоро
luminous - светящийся
thereupon - после этого
superiors - начальство
sulky - угрюмый
strode - шагать
stonily - каменно
starvation - голодание
yawl - рыскание
yawned - зевнул
yell - кричать
varnished - лакированный
haze - туман
flatness - плоскостность
condensed - сжатый
mournful - скорбный
gloom - мрак
brooding - задумчивый
